# Map with corridor
NO ./textures/north_wall.xpm
SO ./textures/south_wall.xpm
WE ./textures/west_wall.xpm
EA ./textures/east_wall.xpm
F 50,50,50
C 255,255,200

11111111111111111111
10000000000000000001
10000000000000000001
10001111111111100001
10001000000000100001
100010N0000000100001
10001000000000100001
10001111111111100001
10000000000000000001
10000000000000000001
11111111111111111111