# Map with multiple rooms
NO ./textures/north_wall.xpm
SO ./textures/south_wall.xpm
WE ./textures/west_wall.xpm
EA ./textures/east_wall.xpm
F 40,40,40
C 200,200,200

11111111111111111111111111111111
10000000000010000000000000000001
10000000000010000000000000000001
10001111111111111110000000000001
10001000000000000010000000000001
100010N0000000000010000000000001
10001000000000000010000000000001
10001111111111111110000000000001
10000000000000000000000000000001
10000000000000000000000000000001
11111111111111111111111111111111