# Complex map with obstacles
NO ./textures/north_wall.xpm
SO ./textures/south_wall.xpm
WE ./textures/west_wall.xpm
EA ./textures/east_wall.xpm
F 100,50,100
C 50,150,150

111111111111111111111111111111111111111111
100000000000000000000000000000000000000001
100011111000000000000000000000000000000001
100010001000000000000000000000000000000001
100010N01000000000000000000000000000000001
100010001000000000000000000000000000000001
100011111000000000000000000000000000000001
100000000000000000000000000000000000000001
100000000000000000000000000000000000000001
100000000000000000000000000000000000000001
111111111111111111111111111111111111111111